#,#,#,#,#,#,#,#,#,#,#,#,#
#,.,#,.,.,H,.,.,#,*,.,C,#
#,O,#,.,.,#,#,.,.,.,#,.,#
#,.,#,.,.,#,#,#,#,#,#,F,#
#,.,P,.,.,.,*,#,.,.,R,.,#
#,#,.,#,#,#,#,#,#,#,#,.,#
#,.,.,B,.,.,.,G,.,.,.,.,#
#,#,#,#,#,#,#,#,#,#,#,#,#


#,#,#,#,#,#,#,#,#,#,#,#,#,#,#,#,#,#,#,#,#,#,#,#,#.#,#,#
#,.,.,.,.,.,.,.,.,.,.,.,.,.,.,.,.,.,.,.,.,.,.,.,.,.,.,#
#,.,.,#,#,#,#,.,.,#,#,#,#,.,.,#,#,#,#,.,.,#,#,#,#,.,.,#
#,.,.,#,.,.,.,.,.,#,.,.,#,.,.,#,.,.,.,.,.,#,.,.,.,.,.,#
#,.,.,#,.,.,.,.,.,#,.,.,#,.,.,#,.,.,.,.,.,#,.,.,.,.,.,#
#,.,.,#,#,#,#,.,.,#,#,#,#,.,.,#,#,#,#,.,.,#,#,#,#,.,.,#
#,.,.,#,.,.,.,.,.,#,.,.,.,.,.,.,.,.,#,.,.,#,.,.,.,.,.,#
#,.,.,#,.,.,.,.,.,#,.,.,.,.,.,.,.,.,#,.,.,#,.,.,.,.,.,#
#,.,.,#,.,.,.,.,.,#,.,.,.,.,.,#,#,#,#,.,.,#,#,#,#,.,.,#
#,.,.,.,.,.,.,.,.,.,.,.,.,.,.,.,.,.,.,.,.,.,.,.,.,.,.,#
#,.,.,.,.,.,.,.,.,.,.,.,.,.,.,.,.,.,.,.,.,.,.,.,.,.,.,#
#,#,#,#,#,#,#,#,#,#,#,#,#,#,#,#,#,#,#,#,#,#,#,#,#,#,#,#