#,#,#,#,#,#,#,#,#,#,#,#,#
#,.,#,.,.,H,.,.,#,*,.,C,#
#,O,#,.,.,#,#,.,.,.,#,.,#
#,.,.,.,.,.,.,G,.,.,.,.,#
#,#,#,#,#,#,#,#,#,#,#,#,#