#,#,#,#,#,#,#,#,#,#,#,#,#
#,.,#,.,.,.,.,.,#,*,.,C,#
#,.,#,.,.,#,#,.,.,.,#,.,#
#,.,#,.,.,#,#,#,#,#,#,.,#
#,.,R,.,.,.,*,#,.,.,R,.,#
#,#,.,#,#,#,#,#,#,#,#,.,#
#,.,.,.,.,.,.,.,.,.,.,.,#
#,#,#,#,#,#,#,#,#,#,#,#,#