#,#,#,#,#,#,#,#,#,#,#,#,#
#,.,#,.,.,H,.,.,#,*,.,C,#
#,.,#,.,.,#,#,.,.,.,#,.,#
#,.,#,.,.,#,#,#,#,#,#,F,#
#,.,R,.,.,.,*,#,.,.,R,.,#
#,#,.,#,#,#,#,#,#,#,#,.,#
#,.,.,.,.,.,.,G,.,.,.,.,#
#,#,#,#,#,#,#,#,#,#,#,#,#