#,#,#,#,#,#,#,#,#,#,#,#,#
#,.,#,.,.,H,.,.,#,*,.,C,#
#,.,#,.,.,#,#,.,.,.,#,.,#
#,.,#,.,.,#,#,#,#,#,#,F,#
#,.,P,.,.,.,*,#,.,.,R,.,#
#,#,.,#,#,#,#,#,#,#,#,#,#
#,.,.,.,.,.,.,G,.,.,.,.,#
#,#,#,#,#,#,#,#,#,#,#,#,#